0,1,3,6,10,5,6,7,8,9
2,4,7,4,5,6,7,8,9,10
5,8,4,5,6,7,8,9,10,11
9,4,5,6,7,8,9,10,11,12
4,5,6,7,8,9,10,11,12,13
5,6,7,8,9,10,11,12,13,14
6,7,8,9,10,11,12,13,14,15
7,8,9,10,11,12,13,14,15,16
8,9,10,11,12,13,14,15,16,17
9,10,11,12,13,14,15,16,17,18